1 1 1 1 1 1 1 1 1 1 1 1 1 1 1 1 1 1 1 1 1 1 1 1 1 1 1 1 1 1 1 1 1 1 1 1 1 1 1
1 P1 0 0 1 0 1 0 0 0 0 0 0 0 0 I 1 I I S I I I I I 0 1 P2 1 0 0 0 0 0 1 0 0 0 1
1 1 1 0 1 0 1 0 1 1 1 0 1 1 1 I 1 I 1 1 1 I 1 1 1 0 1 0 1 0 1 1 1 0 1 0 1 0 1
1 0 F 0 1 0 0 0 1 F F 0 1 0 1 I I I I I I I 1 0 1 0 1 0 0 0 0 H 1 F F F 1 0 1
1 0 F 0 1 0 0 0 1 0 0 0 1 0 1 I I I I I I I 1 0 1 0 1 0 0 0 0 H 1 F F F 1 0 1
1 0 1 1 1 0 1 1 1 0 1 1 1 0 1 1 1 1 1 1 1 1 1 F 1 0 1 1 1 1 1 1 1 1 1 0 1 0 1
1 0 F 0 1 0 1 0 F 0 1 0 0 0 1 F 0 0 0 F 0 0 0 0 1 0 0 0 1 0 0 0 0 0 1 N 1 0 1
1 0 1 0 1 1 1 0 1 1 1 0 1 0 1 0 1 1 1 1 1 0 1 0 1 1 1 0 1 0 1 1 1 0 1 1 1 0 1
1 0 1 0 0 F 0 0 1 H 1 0 1 0 H 0 1 0 1 H 0 0 1 F 1 0 1 0 0 0 1 0 1 0 0 0 0 0 1
1 0 1 1 1 1 1 1 1 0 1 0 1 1 1 1 1 0 1 0 1 1 1 0 1 0 1 1 1 1 1 0 1 1 1 1 1 0 1
1 0 0 0 H H 1 0 0 0 1 0 0 0 H 0 0 F 1 0 1 0 H 0 1 0 H 0 0 H 0 0 1 F 0 0 F 0 1
1 0 1 1 1 1 1 0 1 0 1 0 1 1 1 1 1 0 1 0 1 1 1 0 1 0 1 0 1 1 1 1 1 0 1 1 1 1 1
1 0 0 F 0 0 0 0 1 F 0 0 1 0 0 0 1 0 1 0 0 0 1 0 1 0 1 0 0 0 1 0 H 0 1 H 0 0 1
1 0 1 1 1 1 1 1 1 1 1 1 1 0 1 F 1 1 1 1 1 0 1 0 1 1 1 1 1 0 1 0 1 1 1 0 1 1 1
1 0 F 0 0 0 1 0 H 0 1 0 0 0 1 0 1 0 0 0 0 P3 1 0 0 0 0 0 0 0 1 0 F 0 1 0 0 0 1
1 1 1 1 1 0 1 0 1 0 1 0 1 1 1 F 1 0 1 1 1 1 1 0 1 1 1 1 1 1 1 1 1 0 1 1 1 0 1
1 0 0 0 1 0 I 0 1 F 1 F 1 0 1 0 F 0 1 0 0 0 F 0 1 0 I 0 I 0 F 0 1 0 0 I 0 0 1
1 0 1 0 1 1 1 1 1 0 1 0 1 0 1 1 1 1 1 0 1 1 1 1 1 0 1 1 1 0 1 1 1 1 1 1 1 0 1
1 0 1 0 0 0 0 0 0 0 1 0 1 0 0 F 0 0 1 0 H 0 1 0 0 F 0 0 1 H 1 0 0 0 0 0 0 0 1
1 0 1 1 1 1 1 1 1 1 1 0 1 0 1 1 1 1 1 1 1 0 1 0 1 1 1 1 1 0 1 0 1 1 1 1 1 1 1
1 0 0 0 1 0 0 0 1 0 0 0 1 0 1 0 0 0 H 0 0 0 1 0 0 0 1 0 0 H 1 0 1 0 F 0 H H 1
1 1 1 0 1 1 1 0 1 0 1 1 1 0 1 0 1 1 1 1 1 1 1 1 1 0 1 0 1 1 1 D3 1 0 1 1 1 0 1
1 H 1 0 H 0 D1 0 1 0 0 0 1 0 I 0 F 0 0 0 0 0 1 P4 1 0 1 0 0 0 0 0 1 0 0 P5 1 0 1
1 F 1 1 1 1 1 0 1 1 1 0 1 1 1 1 1 1 1 1 1 0 1 0 1 0 1 1 1 1 1 1 1 1 1 1 1 0 1
1 0 0 0 1 F 0 0 1 H 1 0 I 0 0 H 1 0 0 0 1 0 0 0 1 0 1 0 0 0 0 0 1 0 0 0 0 0 1
1 0 1 0 1 0 1 1 1 0 1 1 1 1 1 0 1 0 1 0 1 1 1 1 1 0 1 0 1 1 1 0 1 0 1 1 1 0 1
1 0 1 0 1 0 0 I 0 0 1 0 0 0 D2 0 0 0 1 0 0 0 I 0 0 0 1 0 1 0 1 0 0 0 1 0 1 0 1
1 F 1 F 1 1 1 1 1 0 1 0 1 1 1 1 1 1 1 1 1 1 1 1 1 1 1 0 1 0 1 1 1 1 1 0 1 0 1
1 0 1 0 0 H 0 0 1 F 1 0 0 I 0 0 I 0 1 0 0 I 0 0 F 0 0 0 1 H 0 0 0 H 0 0 1 0 1
1 I 1 0 1 1 1 1 1 0 1 0 1 1 1 0 1 1 1 0 1 1 1 1 1 0 1 1 1 0 1 1 1 1 1 0 1 0 1
1 0 1 0 1 0 H 0 1 0 1 0 0 0 1 0 1 0 0 0 1 0 F 0 1 0 1 H 0 0 0 0 0 0 1 I 1 0 1
1 0 1 0 1 0 1 I 1 F 1 1 1 0 1 0 1 I 1 1 1 0 1 I 1 0 1 1 1 1 1 1 1 0 1 0 1 0 1
1 F 1 0 0 I 1 0 1 0 1 0 1 I 1 0 0 0 1 0 1 F 1 0 H 0 1 0 0 0 0 0 1 0 1 0 1 0 1
1 0 1 1 1 1 1 0 1 0 1 0 1 0 1 1 1 1 1 0 1 F 1 1 1 1 1 0 1 1 1 0 1 1 1 I 1 0 1
1 0 0 0 0 0 1 F 0 0 1 0 0 I 0 0 0 I 0 0 1 0 1 0 0 F 0 0 F H 1 0 0 F 0 0 1 0 1
1 1 1 1 1 0 1 1 1 1 1 1 1 1 1 1 1 1 1 1 1 0 1 H 1 1 1 1 1 0 1 1 1 1 1 1 1 0 1
1 N 1 0 0 I 1 0 0 0 0 0 1 0 0 H 0 0 0 H 0 0 1 0 0 0 1 H 1 0 F 0 0 0 I 0 0 H 1
1 D5 1 0 1 1 1 H 1 1 1 0 1 0 1 1 1 1 1 1 1 1 1 1 1 0 1 H 1 1 1 1 1 1 1 1 1 1 1
1 0 0 0 H 0 0 0 1 0 0 H 0 0 1 N 0 H H H H 0 0 0 D4 0 I F I F I F I F I F I G 1
1 1 1 1 1 1 1 1 1 1 1 1 1 1 1 1 1 1 1 1 1 1 1 1 1 1 1 1 1 1 1 1 1 1 1 1 1 1 1