1 1 1 1 1 1 1 1 1 1 1 1 1 1 1 1 1 1 1 1 1 1 1 1 1 1 1 1 1 1 1 1 1 1 1 1 1 1 1 1 1 1 1 1 1 1 1 1 1 1 1 1 1 1 1 1 1 1 1 1 1 1 1 1 1 1 1 1 1 1 
1 S N 0 F 0 F P2 F 0 F 0 F I F 0 0 N 1 0 F 1 I I 0 0 0 0 0 0 1 0 0 0 0 H F 0 0 0 0 0 0 0 0 0 0 0 1 0 0 0 0 F 0 I F 1 0 H 0 F 0 0 C 0 0 0 N 1 
1 L 0 0 1 F 0 F F F 0 F 0 I 0 0 0 0 1 I 0 1 F 0 0 0 0 F 0 0 1 0 0 I 0 0 0 0 0 0 0 0 0 0 0 0 0 0 1 0 F 0 0 0 0 0 0 1 0 0 0 0 0 F 0 0 0 I 0 1 
1 1 1 1 1 1 1 1 1 1 1 1 1 1 1 1 0 0 1 0 0 1 0 0 1 1 1 1 I 0 1 0 0 1 1 1 1 1 1 1 0 0 1 0 0 1 0 F 1 1 1 1 0 0 1 0 0 1 F 0 1 1 1 1 1 1 1 0 0 1 
1 N 0 1 0 0 I 0 F 0 F 0 0 0 H 1 0 0 1 0 0 1 0 F C I 0 1 F 0 0 0 0 1 I 0 0 0 0 1 0 F 1 0 0 1 0 0 0 0 I 0 F F 1 0 0 0 0 0 1 0 0 0 0 I 1 0 F 1 
1 0 0 1 0 0 0 I 0 0 0 0 0 F 0 1 0 H 1 0 0 1 0 0 0 0 0 1 0 0 0 0 0 1 0 0 0 0 0 1 0 0 1 0 0 1 0 0 0 0 0 0 0 0 1 F 0 0 0 0 1 0 I 0 I F 1 0 0 1 
1 D1 D1 1 F 0 1 1 1 1 D2 D2 1 1 1 1 I 0 1 0 0 1 1 1 1 0 0 1 1 1 1 1 1 1 0 0 1 0 0 1 1 1 1 0 0 1 1 1 1 1 1 1 1 1 1 1 1 1 1 1 1 0 F 1 0 0 1 0 0 1 
1 F F 0 0 0 1 0 0 1 F 0 0 0 0 1 F 0 1 0 0 0 0 0 0 0 0 1 0 I 1 0 0 I 0 0 1 0 0 0 0 I 0 0 0 1 0 I F F 0 0 0 I 0 0 I 1 0 0 I 0 0 1 0 0 1 H 0 1 
1 0 I 0 0 0 1 0 0 1 0 0 0 0 I 1 0 0 1 0 0 0 0 0 0 0 0 1 0 0 1 I 0 0 0 0 1 0 0 0 F 0 0 0 0 1 F 0 I 0 0 0 0 0 I 0 0 1 0 0 0 0 0 1 0 0 1 F I 1 
1 0 0 1 1 1 1 0 0 1 1 1 1 0 0 1 0 C 1 0 0 1 1 1 1 1 1 1 I 0 1 0 F 1 1 1 1 0 0 1 1 1 1 1 1 1 0 0 1 1 1 1 1 1 1 0 0 1 0 0 1 0 0 1 0 0 1 0 0 1 
1 F I 1 P1 0 0 0 0 F H 0 1 0 I I F 0 1 0 0 0 0 I I 0 0 0 H 0 1 0 0 1 0 I 0 0 F 1 0 0 0 0 0 0 0 0 0 0 0 1 0 0 0 F 0 1 0 0 1 0 0 1 0 0 1 0 0 1 
1 I I 1 0 0 I 0 I 0 0 0 1 0 0 0 0 0 1 0 0 0 0 0 I 0 0 0 0 0 1 0 F 1 0 0 0 0 0 1 0 0 0 0 0 0 0 0 0 I 0 1 0 0 0 I 0 1 0 0 1 0 0 1 0 0 1 0 F 1 
1 1 0 1 1 1 1 0 0 1 0 0 1 1 1 1 1 1 1 0 0 1 1 1 1 1 1 1 1 1 1 0 F 1 0 0 1 1 1 1 0 0 1 1 1 1 1 1 1 1 1 1 0 0 1 1 1 1 1 1 1 0 0 1 F 0 1 0 0 1 
1 0 0 0 0 I 1 0 0 1 0 F 0 0 0 1 0 0 0 0 0 1 N 0 0 0 0 0 0 0 F H F 1 I 0 0 0 0 1 F 0 1 0 0 1 0 0 0 I 0 0 0 I 1 0 0 0 0 0 F 0 0 1 0 I 1 0 0 1 
1 0 1 0 F 0 1 0 0 1 0 0 0 0 0 1 0 0 F 0 0 1 0 0 0 0 0 I 0 0 F F F 1 0 0 0 0 0 1 0 0 1 0 0 1 0 0 0 0 0 0 0 F 1 0 0 0 0 0 0 0 0 1 0 0 1 0 0 1 
1 1 1 1 0 0 1 0 H 1 1 1 1 0 0 1 0 F 1 1 1 1 0 F 1 1 1 1 0 0 1 1 1 1 1 1 1 1 1 1 0 0 1 0 0 1 0 0 1 1 1 1 1 1 1 0 0 1 1 1 1 1 1 1 0 F 1 I I 1 
1 0 0 1 0 0 1 0 0 1 0 0 1 0 0 0 0 0 1 0 0 0 F 0 1 0 I 0 0 0 1 0 0 0 F 0 0 0 0 0 0 0 1 0 0 1 0 0 1 I F I I 0 0 F 0 0 0 0 1 0 F 0 0 0 1 0 0 1 
1 0 0 1 0 0 1 F 0 1 0 0 1 0 0 I 0 0 1 F 0 0 0 0 1 F 0 0 0 0 1 0 0 0 0 0 F 0 0 0 0 I 1 0 0 1 0 0 1 0 F I I 0 0 H 0 0 0 0 1 0 0 0 0 0 1 0 F 1 
1 0 0 1 0 0 1 0 C 1 0 0 1 1 1 1 1 1 1 0 0 1 1 1 1 0 0 1 1 1 1 0 0 1 1 1 1 1 1 1 1 1 1 0 0 1 0 0 1 1 1 1 1 1 1 1 1 1 0 0 1 0 0 1 1 1 1 I I 1 
1 0 F 0 0 I 1 0 F 0 0 0 0 0 0 1 0 0 1 0 0 1 0 0 0 0 F 1 0 F H F 0 1 0 0 0 0 0 0 F 0 1 0 0 1 0 0 0 I 0 0 0 0 0 0 F 1 0 0 1 0 0 1 0 0 0 0 0 1 
1 0 1 0 0 0 1 0 I 0 F 0 0 0 0 1 0 0 1 F 0 1 0 0 0 0 C 1 0 0 I 0 0 1 F 0 I 0 0 F 0 0 1 0 0 1 0 F 0 F 0 0 0 0 0 0 0 1 0 0 1 0 F 1 0 0 0 0 F 1 
1 0 I 1 1 1 1 1 1 1 1 1 1 0 0 1 0 0 1 F 0 1 1 1 1 1 1 1 0 0 1 1 1 1 0 0 1 1 1 1 0 0 1 0 0 1 1 1 1 1 1 1 1 1 1 0 0 1 0 0 1 0 0 1 0 0 1 1 1 1 
1 0 0 0 0 I I I 0 0 0 I 1 I F 0 0 0 1 0 0 0 0 0 1 0 0 0 0 0 1 0 0 0 0 0 1 0 0 0 0 0 1 I 0 0 0 0 0 0 0 1 0 0 0 0 I 1 F 0 1 0 0 1 0 0 0 0 0 1 
1 0 0 0 0 0 I I 0 0 0 0 1 0 0 F 0 0 1 F 0 0 0 0 1 0 0 F 0 0 1 0 0 0 0 0 1 0 0 0 0 I 1 0 0 I 0 0 0 0 I 1 0 C 0 0 0 1 0 0 1 0 0 1 F 0 0 F 0 1 
1 1 1 1 1 1 1 1 1 1 I 1 1 1 1 1 0 0 1 1 1 1 0 0 1 0 0 1 1 1 1 1 1 1 0 0 1 0 I 1 1 1 1 1 1 1 1 1 1 0 0 1 I 0 1 1 1 1 0 0 1 1 1 1 1 1 1 0 0 1 
1 0 H 1 1 0 0 I 1 I F 0 1 F 0 1 F 0 1 0 0 1 0 0 1 0 0 1 I 0 0 0 I 0 I 0 1 0 0 0 0 0 0 0 F N 0 0 I 0 0 1 0 0 1 0 0 0 0 0 1 I 0 0 0 0 0 0 0 1 
1 0 F 1 0 0 1 0 F I 1 0 1 0 0 1 0 0 1 0 I 1 0 I 1 0 0 1 0 0 0 0 0 0 0 0 1 0 0 0 0 0 0 I 0 0 0 0 I F 0 1 F 0 1 0 0 C 0 F 1 0 0 I 0 0 0 0 0 1 
1 0 0 1 0 0 1 1 1 1 1 1 1 I 0 1 0 0 1 0 0 1 0 0 1 0 0 1 0 I 1 1 1 1 1 1 1 0 F 1 1 1 1 1 1 1 1 1 1 0 0 1 0 0 1 1 1 1 0 F 1 0 0 1 1 1 1 1 1 1 
1 0 0 I 0 0 1 0 0 1 0 0 0 I 0 0 0 I 1 0 F 1 0 0 0 0 I 0 0 0 1 F 0 0 0 I 1 0 0 1 0 0 0 0 0 1 0 0 0 0 I 1 0 0 1 0 0 0 0 0 1 I 0 1 0 0 0 I 0 1 
1 I 0 I 0 0 1 0 0 1 F 0 0 0 0 0 I 0 1 0 0 1 0 0 0 F 0 0 I 0 1 0 0 0 0 I 1 0 0 1 0 0 0 0 0 1 0 0 0 0 F 1 0 F 1 0 0 F 0 0 1 0 0 1 0 0 0 0 0 1 
1 0 F 1 1 1 1 0 0 1 0 0 1 1 1 1 1 1 1 0 0 1 1 1 1 1 1 1 1 1 1 0 0 1 0 0 1 1 1 1 0 0 1 0 0 1 1 1 1 1 1 1 0 0 1 0 I 1 1 1 1 0 I 1 0 0 1 0 I 1 
1 0 0 1 0 0 0 0 0 1 0 F 0 I 0 0 0 0 0 0 0 F 0 0 I 0 0 1 0 0 0 0 0 1 0 0 1 0 0 0 0 I 1 0 I 0 0 0 0 I 0 0 I 0 1 0 N 1 0 0 0 I 0 1 F 0 1 0 0 1 
1 0 F 1 0 0 0 0 F 1 0 0 0 0 0 0 F 0 0 0 0 0 0 F 0 0 0 1 0 0 0 0 0 1 0 0 1 0 0 0 0 0 1 F 0 0 0 0 0 0 0 0 0 0 1 0 0 1 0 0 0 0 0 1 0 F 1 0 0 1 
1 F F 1 0 0 1 0 0 1 1 1 1 1 1 1 1 1 1 1 1 1 1 1 1 0 0 1 0 0 1 1 1 1 0 0 1 0 0 1 1 1 1 1 1 1 1 1 1 1 1 1 1 1 1 0 0 1 0 0 1 1 1 1 1 1 1 0 0 1 
1 I F 1 0 0 1 0 0 I 0 0 0 0 0 0 0 0 0 0 0 0 0 I 0 F 0 1 0 0 1 0 0 I 0 0 1 0 0 F I I 0 0 0 0 0 0 0 I 0 1 0 0 I 0 0 0 0 0 1 F 0 0 F 0 1 0 0 1 
1 F F 1 0 0 1 0 0 0 0 0 0 0 0 0 0 0 F 0 0 F 0 0 0 I 0 1 0 0 1 0 0 0 0 0 1 0 0 0 0 I 0 I 0 0 0 0 0 0 0 1 0 0 I F I 0 0 0 1 0 0 0 0 0 1 0 0 1 
1 0 0 1 0 F 1 1 1 1 1 1 1 1 1 1 1 1 1 1 1 1 1 1 1 1 1 1 0 0 1 0 0 1 1 1 1 0 0 1 1 1 1 1 1 1 1 1 1 0 0 1 I I 1 1 1 1 1 1 1 I 0 1 0 0 1 0 0 1 
1 0 0 1 0 0 1 F 0 0 0 0 0 0 0 0 0 0 0 0 0 0 0 F F 0 0 0 I 0 1 0 0 1 0 0 1 0 0 0 0 0 0 F 0 1 0 0 1 0 0 1 0 0 0 I 0 0 0 0 0 0 0 1 0 0 0 0 0 1 
1 0 0 1 F 0 1 0 F 0 0 0 0 I 0 I I 0 0 0 0 0 0 I F 0 0 0 0 0 1 I 0 1 0 0 1 0 0 0 0 0 0 0 I 1 0 F 1 0 0 1 0 0 0 0 0 0 F 0 0 0 0 1 0 0 F 0 0 1 
1 0 0 1 1 1 1 0 0 1 1 1 1 1 1 1 1 1 1 1 1 1 1 1 1 1 1 1 1 1 1 0 0 1 0 0 1 1 1 1 1 1 1 I 0 1 0 0 1 0 0 1 1 1 1 I 0 1 1 1 1 1 1 1 1 1 1 0 0 1 
1 0 0 0 0 0 1 0 0 0 0 0 1 I I 0 0 0 F 0 0 1 0 I 1 0 0 0 0 0 0 I 0 0 0 F 0 0 0 0 0 0 0 0 0 0 0 0 1 0 0 0 0 0 1 F 0 1 F 0 0 I 0 0 I 0 1 0 0 1 
1 F I 0 0 0 1 I 0 0 0 0 1 0 0 0 0 0 0 0 0 0 0 0 1 0 0 0 0 0 0 0 I 1 0 0 F 0 0 I 0 0 0 0 I 0 0 0 1 I I I 0 0 1 0 0 1 F 0 0 I 0 0 0 0 1 0 I 1 
1 F 1 1 0 I 1 1 1 1 I 0 1 0 I 1 1 1 1 1 1 1 I 0 1 0 0 1 1 1 1 1 1 1 1 1 1 1 1 1 1 1 1 1 1 1 1 1 1 1 1 1 0 I 1 0 I 1 0 0 1 1 1 1 0 F 1 0 0 1 
1 0 0 1 0 0 0 0 0 0 F 0 1 F 0 F 0 0 1 0 0 0 0 0 1 0 0 0 0 I 1 0 0 0 0 I 0 0 I 0 0 0 0 0 F 0 0 0 1 0 0 0 0 I 1 0 0 1 I 0 1 0 0 1 0 0 1 0 I 1 
1 0 0 1 0 0 0 0 0 0 0 0 1 0 0 F 0 0 1 0 I 0 F 0 1 0 0 0 0 F 1 0 F 0 0 0 0 0 0 0 0 0 0 0 0 0 I 0 1 I 0 I 0 0 1 0 0 1 0 0 1 0 0 1 0 0 1 0 0 1 
1 I 0 1 1 1 1 1 1 1 1 1 1 1 1 1 1 1 1 0 0 1 1 1 1 1 1 1 0 0 1 I 0 1 1 1 1 1 1 1 1 1 1 1 1 1 0 0 1 0 0 1 1 1 1 0 0 1 0 0 1 0 0 1 F I 1 0 0 1 
1 0 0 0 0 0 F 0 0 0 0 0 0 0 0 0 F 0 1 0 0 0 0 0 1 0 0 0 0 0 1 0 0 1 I 0 0 I 0 1 I 0 0 F I 1 0 0 0 0 0 1 0 0 0 0 0 1 0 F 0 0 0 1 0 0 1 0 I 1 
1 0 0 0 0 0 F 0 F 0 0 0 0 0 0 0 I F 1 0 F 0 0 0 1 I I I 0 0 1 0 0 1 0 F I 0 I 1 0 I 0 0 0 1 0 0 0 0 0 1 0 0 0 0 0 1 F 0 0 0 0 1 0 0 1 0 0 1 
1 1 1 1 1 1 1 1 1 1 1 1 1 0 0 1 0 0 1 0 0 1 0 0 1 0 0 1 1 1 1 0 0 1 0 0 1 F 0 1 I 0 1 1 1 1 1 1 1 0 0 1 1 1 1 1 1 1 1 1 1 0 0 1 0 0 1 F 0 1 
1 0 I 1 0 F 0 0 0 1 0 0 0 0 0 1 0 I 1 0 0 1 0 0 1 0 0 1 0 0 0 0 0 0 0 0 1 0 0 1 0 0 1 0 0 0 I 0 1 0 0 1 0 0 0 F 0 0 0 0 1 0 0 1 0 I 1 0 0 1 
1 0 0 1 0 0 0 0 0 1 0 0 0 0 0 1 0 0 1 0 0 1 0 I 1 0 I 1 0 0 0 I F 0 0 0 1 0 0 1 0 0 1 0 F 0 F 0 1 0 0 1 0 0 F 0 0 0 0 0 1 0 0 1 F 0 1 F 0 1 
1 0 0 1 0 0 1 0 0 1 0 0 1 1 1 1 0 F 1 1 1 1 0 0 1 0 0 1 1 1 1 1 1 1 1 1 1 0 N 1 0 F 1 0 0 1 0 0 1 0 0 1 0 0 1 1 1 1 0 0 1 0 0 1 0 0 1 0 0 1 
1 0 0 1 0 0 1 0 0 I 0 0 1 0 0 0 I 0 I 0 0 0 0 I 1 0 I I 0 0 1 0 F 0 0 0 1 0 0 1 0 0 0 0 0 1 0 0 0 0 0 1 0 0 1 F 0 0 F 0 1 0 0 1 0 0 1 0 0 1 
1 0 0 1 0 F 1 0 0 0 0 0 1 0 0 I 0 I I 0 0 0 0 0 1 0 0 0 I 0 1 0 I 0 0 0 1 0 0 1 0 0 0 0 0 1 0 0 0 F 0 1 0 0 1 0 0 0 0 0 1 0 0 1 I 0 1 0 F 1 
1 0 I 1 0 0 1 1 1 1 0 0 1 1 1 1 1 1 1 1 1 1 1 1 1 1 1 1 0 0 1 0 F 1 0 0 1 0 0 1 0 0 1 1 1 1 1 1 1 1 1 1 F 0 1 0 0 1 1 1 1 0 0 1 0 0 1 1 1 1 
1 I 0 1 0 0 0 0 0 1 0 0 1 0 0 0 0 0 0 0 0 0 0 0 I 0 0 1 0 0 1 0 0 1 0 F 0 0 0 1 0 0 1 0 0 0 0 0 F 0 0 0 I 0 1 0 0 0 0 0 0 0 F 1 0 0 0 0 0 1 
1 0 0 1 I 0 0 0 0 1 0 0 1 F 0 0 0 0 0 0 0 0 0 0 0 F 0 1 0 0 1 0 0 1 I 0 0 0 0 1 0 0 1 0 F 0 0 0 0 0 0 0 0 0 1 I C 0 0 0 0 0 0 1 0 0 F 0 0 1 
1 0 F 1 1 1 1 0 F 1 0 F 1 I F 1 1 1 1 1 1 1 0 0 1 0 F 1 I 0 1 0 0 1 1 1 1 1 1 1 1 1 1 0 0 1 1 1 1 1 1 1 1 1 1 1 1 1 1 1 1 0 I 1 1 1 1 0 0 1 
1 0 0 1 0 0 0 0 0 1 0 0 1 0 0 1 0 0 0 0 0 1 0 0 1 0 I 1 0 F 1 0 I 1 0 0 F I F 1 0 0 0 0 0 1 0 0 1 0 0 0 0 0 0 0 0 0 F 0 1 0 0 1 0 I 0 0 0 1 
1 I 0 1 0 F 0 0 0 1 F 0 1 0 0 1 0 0 0 0 0 1 0 0 1 0 F 1 0 0 1 0 0 1 F 0 0 0 0 1 0 0 F 0 I 1 0 C 1 0 0 0 0 0 F N 0 0 F F 1 0 I 1 0 0 0 0 0 1 
1 I 0 1 0 0 1 1 1 1 0 0 1 0 0 1 1 1 1 0 0 1 0 0 1 1 1 1 0 0 1 0 0 1 0 0 1 0 0 1 0 0 1 1 1 1 0 0 1 0 0 1 1 1 1 1 1 1 0 0 1 1 1 1 F 0 1 0 0 1 
1 0 0 1 0 C I 0 0 1 0 I 1 0 0 0 0 0 H 0 0 1 0 F 0 0 0 0 0 0 1 I F 0 F 0 1 0 0 0 0 0 0 F 0 0 F 0 1 0 0 0 0 0 1 0 0 0 0 0 1 0 0 0 0 0 1 0 0 1 
1 0 0 1 0 I 0 F 0 1 0 0 1 0 0 0 0 0 0 0 0 1 0 0 F 0 0 0 0 I 1 0 0 0 0 0 1 0 0 0 0 0 0 0 0 F 0 0 1 0 0 0 0 F 1 0 0 0 0 0 1 0 0 0 0 I 1 0 0 1 
1 0 I 1 1 1 1 0 0 1 1 1 1 1 1 1 1 1 1 0 0 1 1 1 1 1 1 1 1 1 1 1 1 1 1 1 1 1 1 1 1 1 1 1 1 1 1 1 1 1 1 1 0 0 1 0 0 1 1 1 1 0 0 1 1 1 1 0 0 1 
1 0 0 0 0 0 1 0 0 0 0 0 0 F I 0 0 0 0 0 0 1 0 0 I 0 0 0 0 I 0 0 I I 0 F F 0 0 F 0 0 0 0 0 0 F 0 0 0 0 0 0 0 1 0 0 1 0 0 0 0 0 0 0 0 1 0 0 1 
1 I F 0 F 0 1 0 0 0 0 0 0 0 I 0 I I I 0 0 1 0 0 0 0 0 0 F 0 0 F 0 0 0 0 I 0 0 0 0 0 0 0 0 0 I 0 0 I 0 0 0 0 1 I 0 1 F 0 0 F 0 0 0 F 1 0 0 1 
1 1 1 1 0 0 1 1 1 1 1 1 1 1 1 1 1 1 1 1 1 1 1 1 1 1 1 1 1 1 1 F 0 1 1 1 1 1 1 1 1 1 1 1 1 1 1 1 1 1 1 1 1 1 1 0 0 1 1 1 1 1 1 1 0 I 1 I I 1 
1 0 F 0 0 0 1 0 0 0 0 0 0 F 0 0 I 0 0 0 0 0 0 0 0 0 0 I 0 0 0 0 I 1 0 F 0 0 I 0 0 0 0 0 0 0 0 0 0 0 0 0 0 0 0 0 0 0 0 0 0 0 0 0 0 0 1 I I 1 
1 N 0 0 0 0 0 0 0 F 0 0 0 0 I 0 0 0 0 0 0 0 F 0 0 0 0 0 0 0 0 0 0 1 0 F 0 0 0 0 I 0 F 0 0 I 0 F 0 I 0 0 0 0 0 0 0 F 0 0 0 0 0 0 0 F 0 0 G 1 
1 1 1 1 1 1 1 1 1 1 1 1 1 1 1 1 1 1 1 1 1 1 1 1 1 1 1 1 1 1 1 1 1 1 1 1 1 1 1 1 1 1 1 1 1 1 1 1 1 1 1 1 1 1 1 1 1 1 1 1 1 1 1 1 1 1 1 1 1 1 
